Project	hppRNA_data								
Seq	RNA-Seq								
Type	Paired-End								
Adaptor	AGATCGGAAGAGC								
Analysis_type	protein-coding								
Core_workflow	1								
Fusion	No								
SNP	No								
Species	Human								
Assembly_Version	hg19								
Working_FOLDER	/data/hppRNA_data								
Software_FOLDER	/data/hppRNA_software								
GATK_FOLDER	/data/hppRNA_software/GATK								
Thread	15								
Tophat: mate-inner-dist	50								
Tophat: mate-std-dev	20								
Tophat/Cufflinks/Cuffdiff: library-type	fr-unstranded								
Subread: minFragLength	50								
Subread: maxFragLength	600								
Subread: PE_orientation	fr								
featureCounts: strandSpecific	0								
RSEM: fragment-length-min	1								
RSEM: fragment-length-max	1000								
RSEM: fragment-length-mean	-1								
RSEM: fragment-length-sd	0								
RSEM: forward-prob	0.5								
Bowtie/HISAT: minins	0								
Bowtie/HISAT: maxins	800								
Bowtie/HISAT: PE_orientation	--fr								
Bowtie/HISAT: nofw/norc									
eXpress: orientation									
Kallisto: l	200								
Kallisto: s	20								
DCC: strand	-N								
#Sample_title	Project	Seq	Type	Species	File	Name	Length	Replicate	Platform
Sample	hppRNA_data	RNA-Seq	Paired-End	Human	ERR315477	brain_3b	101	brain	Illumina 1.9
Sample	hppRNA_data	RNA-Seq	Paired-End	Human	ERR315455	brain_3c	101	brain	Illumina 1.9
Sample	hppRNA_data	RNA-Seq	Paired-End	Human	ERR315432	brain_a	101	brain	Illumina 1.9
Sample	hppRNA_data	RNA-Seq	Paired-End	Human	ERR315352	testis_7a	101	testis	Illumina 1.9
Sample	hppRNA_data	RNA-Seq	Paired-End	Human	ERR315456	testis_7b	101	testis	Illumina 1.9
Sample	hppRNA_data	RNA-Seq	Paired-End	Human	ERR315391	testis_7c	101	testis	Illumina 1.9
#DEG	Control	Case							
DEG	testis	brain							
